10x10
##########
#P  T    #
# ###### #
# #      #
# # #### #
# # #A   #
# # # ####
# # #    #
#   #   S#
##########
