30x10
##############################
#P    #     #    T #         #
# ### # ### # #### # ####### #
# #   #   # #    # #       # #
# # ##### # #### # ####### # #
# # #   A # #    #         # #
# # # ### # # ############ # #
# # # #   # #              # #
#   # #   T #    A      #   S#
##############################
