20x15
####################
#P          T      #
# ##### ##### ######
#       #          #
#   ##### #######  #
#     #         A  #
# ###   #######    #
#           #      #
#   #######   ######
#   #         A    #
# #####   #######  #
#         #        #
#   #####   ########
#   T             S#
####################
